#domain
hospital
#levelname
DunGen13_11_h
#colors
purple: 0, A, T
#initial
             
+++++++++++  
+         +  
+   +++++++  
+   ++++++++ 
+     A 0  + 
+++ ++++++++ 
  + +++++++  
  +      T+  
  +++++++++  
             
#goal
             
+++++++++++  
+    T    +  
+   +++++++  
+  A++++++++ 
+          + 
+++ ++++++++ 
  + +++++++  
  +       +  
  +++++++++  
             
#end
